77777777777777777
90000200020000008
90100010301000108
90020000000020008
90101000301010008
90000000000002008
90101010001010108
90002020000000008
90122200301002008
90000210002200108
90100200302200008
90002020000010108
90100012301002008
90001000000010108
66666666666666666