77777777777777777
90000000000000008
90122102101012108
90000000000000008
90101010101000108
90020000000000008
90100100201212108
90000000000000008
90201000101010108
90000000000000008
90101010101010108
90000200020002008
90101010101010108
90020000200000028
66666666666666666